67 67 67 67 67 67 67 67 67 67 67 67 67 67 67 67 67 67 67 67 67 67 67 67 67 67 67 67 67 67 67 67 67 67 67 67 67 67 67 67 67 67 67 67 67 67 67 67 67 67 
67 67 67 67 67 67 67 67 67 67 67 67 67 67 67 67 67 67 67 67 67 67 67 67 67 67 67 67 67 67 67 67 67 67 67 67 67 67 67 67 67 67 67 67 67 67 67 67 67 67 
67 67 67 67 67 67 67 67 67 67 67 67 67 67 67 67 67 67 67 67 67 67 67 67 67 67 67 67 67 67 67 67 67 67 67 67 67 67 67 67 67 67 67 67 67 67 67 67 67 67 
67 67 67 67 67 67 67 67 67 67 67 67 67 67 67 67 67 67 67 67 67 67 67 67 67 67 67 67 67 67 67 67 67 67 67 67 67 67 67 67 67 67 67 67 67 67 67 67 67 67 
67 67 67 67 67 67 67 67 67 67 67 67 67 67 67 67 67 67 67 67 67 67 67 67 67 67 67 67 67 67 67 67 67 67 67 67 67 67 67 67 67 67 67 67 67 67 67 67 67 67 
67 67 67 67 67 67 67 67 67 67 67 67 67 67 67 67 67 67 67 67 67 67 67 67 67 67 67 67 67 67 67 67 67 67 67 67 67 67 67 67 67 67 67 67 67 67 67 67 67 67 
67 67 67 67 67 67 67 87 87 87 87 87 87 87 87 87 87 87 87 87 87 87 87 87 87 87 87 87 87 87 87 87 87 87 87 87 87 87 87 87 87 87 87 67 67 67 67 67 67 67 
67 67 67 67 67 67 67 87 89 39 87 87 87 87 87 87 87 87 87 87 87 87 87 87 87 87 87 87 87 87 87 87 87 87 87 87 87 87 87 87 87 87 87 67 67 67 67 67 67 67 
67 67 67 67 67 67 67 87 39 39 87 87 87 87 87 39 39 39 39 39 39 87 87 87 87 87 87 87 87 87 87 39 39 39 39 39 39 87 87 87 87 87 87 67 67 67 67 67 67 67 
67 67 67 67 67 67 67 87 87 39 87 87 87 87 39 39 39 39 39 39 39 39 87 87 87 87 87 87 87 87 39 39 39 39 87 87 39 87 87 87 87 87 87 67 67 67 67 67 67 67 
67 67 67 67 67 67 67 87 87 39 39 39 39 39 39 39 39 39 39 39 39 39 87 87 87 87 39 39 39 39 39 39 39 87 87 87 39 39 87 87 87 87 87 67 67 67 67 67 67 67 
67 67 67 67 67 67 67 87 87 87 87 87 87 87 39 39 39 39 39 39 39 39 87 87 87 39 39 39 39 39 39 39 87 87 87 87 87 39 87 87 87 87 87 67 67 67 67 67 67 67 
67 67 67 67 67 67 67 87 87 87 87 87 87 87 87 39 39 39 39 39 39 87 87 87 39 39 39 39 39 39 87 87 87 87 87 87 87 39 39 87 87 87 87 67 67 67 67 67 67 67 
67 67 67 67 67 67 67 87 87 87 87 87 87 87 87 87 87 87 39 87 87 87 87 39 39 39 39 87 87 87 87 87 87 87 87 87 39 39 39 39 87 87 87 67 67 67 67 67 67 67 
67 67 67 67 67 67 67 87 87 87 87 87 87 87 87 87 87 87 39 87 87 87 39 39 39 87 87 87 87 87 87 87 87 87 87 39 39 39 39 39 87 87 87 67 67 67 67 67 67 67 
67 67 67 67 67 67 67 87 87 87 87 87 87 87 87 39 39 39 39 39 87 87 39 39 39 87 87 39 87 87 87 87 87 87 87 39 39 39 39 39 39 87 87 67 67 67 67 67 67 67 
67 67 67 67 67 67 67 87 87 87 87 87 87 39 39 39 87 39 39 39 87 87 39 87 87 87 87 39 87 87 87 87 87 87 39 39 39 39 39 39 39 87 87 67 67 67 67 67 67 67 
67 67 67 67 67 67 67 87 39 39 87 87 87 87 87 87 87 87 39 87 87 87 39 87 87 39 39 39 39 39 87 87 39 39 39 87 87 39 39 39 87 87 87 67 67 67 67 67 67 67 
67 67 67 67 67 67 67 87 39 39 39 39 39 87 87 87 87 87 39 87 87 87 39 87 87 39 39 39 39 39 87 39 39 87 87 87 87 87 39 87 87 87 87 67 67 67 67 67 67 67 
67 67 67 67 67 67 67 87 39 39 39 39 39 87 87 87 87 87 39 87 87 87 39 87 87 39 39 39 39 39 39 39 87 87 87 87 87 87 39 87 87 87 87 67 67 67 67 67 67 67 
67 67 67 67 67 67 67 87 39 39 39 39 39 87 87 87 87 87 39 87 87 87 39 87 87 87 39 39 39 39 87 87 87 87 87 87 87 87 39 87 87 87 87 67 67 67 67 67 67 67 
67 67 67 67 67 67 67 87 39 39 39 39 39 87 87 87 87 87 39 87 87 87 39 39 87 87 87 87 87 87 87 87 87 87 87 87 87 87 39 87 87 87 87 67 67 67 67 67 67 67 
67 67 67 67 67 67 67 87 87 87 39 87 87 87 87 87 87 87 39 87 39 39 39 39 87 87 87 87 87 87 87 87 87 87 87 87 87 87 39 87 87 87 87 67 67 67 67 67 67 67 
67 67 67 67 67 67 67 87 87 87 39 87 87 87 87 87 87 87 39 87 87 87 87 87 87 87 87 87 87 87 87 87 87 87 87 87 87 39 39 39 39 87 87 67 67 67 67 67 67 67 
67 67 67 67 67 67 67 87 87 87 39 87 87 87 39 39 39 39 39 39 39 39 87 87 87 87 87 87 87 87 87 87 87 87 39 39 39 39 39 39 39 87 87 67 67 67 67 67 67 67 
67 67 67 67 67 67 67 87 87 87 39 87 87 39 39 39 39 39 39 39 39 39 39 87 87 87 87 87 87 87 87 87 39 39 39 39 39 39 39 39 39 87 87 67 67 67 67 67 67 67 
67 67 67 67 67 67 67 87 87 87 39 39 39 39 39 39 39 39 39 39 39 39 39 87 87 87 87 87 87 87 87 87 39 39 39 39 39 39 39 39 39 87 87 67 67 67 67 67 67 67 
67 67 67 67 67 67 67 87 87 87 39 39 39 39 39 39 39 39 39 39 39 39 39 87 87 87 87 87 87 87 87 87 39 39 39 39 39 39 39 39 39 87 87 67 67 67 67 67 67 67 
67 67 67 67 67 67 67 87 87 87 87 87 87 87 39 39 39 39 39 39 39 39 39 39 39 39 39 39 39 39 39 39 39 39 39 39 39 87 87 39 39 87 87 67 67 67 67 67 67 67 
67 67 67 67 67 67 67 87 87 87 87 87 87 87 87 87 87 39 39 87 87 87 87 87 87 87 39 87 87 87 87 87 39 39 39 87 87 87 87 39 39 87 87 67 67 67 67 67 67 67 
67 67 67 67 67 67 67 87 87 87 87 87 87 87 87 87 87 39 39 87 87 87 87 87 87 87 39 87 87 87 87 87 87 87 87 87 87 87 39 39 39 87 87 67 67 67 67 67 67 67 
67 67 67 67 67 67 67 87 87 87 87 87 87 87 87 87 87 39 39 87 87 87 87 87 87 87 39 87 87 87 87 87 87 87 87 87 87 87 87 39 39 87 87 67 67 67 67 67 67 67 
67 67 67 67 67 67 67 87 87 87 87 87 87 87 87 87 87 39 39 87 87 87 87 87 87 87 39 87 87 87 87 87 87 87 87 87 87 87 87 87 87 87 87 67 67 67 67 67 67 67 
67 67 67 67 67 67 67 87 87 87 87 87 87 87 87 87 87 39 39 87 87 87 87 87 87 39 39 39 87 87 87 87 87 87 87 87 87 87 87 87 87 87 87 67 67 67 67 67 67 67 
67 67 67 67 67 67 67 87 87 87 87 87 87 87 87 87 87 39 39 87 87 87 87 87 87 39 39 39 87 87 87 87 87 87 87 87 87 87 87 87 87 87 87 67 67 67 67 67 67 67 
67 67 67 67 67 67 67 87 87 87 87 87 87 87 87 39 39 39 39 39 39 87 87 87 87 87 87 87 87 87 87 87 87 87 87 87 87 87 87 87 87 87 87 67 67 67 67 67 67 67 
67 67 67 67 67 67 67 87 87 87 87 87 87 87 87 39 39 39 39 39 39 87 87 87 87 87 87 87 87 87 87 87 87 87 87 87 87 87 87 87 87 87 87 67 67 67 67 67 67 67 
67 67 67 67 67 67 67 87 87 39 39 39 39 39 39 39 39 39 39 39 39 87 87 87 87 87 87 87 87 87 87 87 87 87 87 87 39 39 39 39 39 87 87 67 67 67 67 67 67 67 
67 67 67 67 67 67 67 87 87 39 87 87 87 87 87 39 39 39 39 39 39 87 87 87 87 87 87 87 87 87 87 87 39 39 39 39 39 39 87 87 39 87 87 67 67 67 67 67 67 67 
67 67 67 67 67 67 67 87 87 39 87 87 87 87 87 39 39 39 39 39 39 87 87 87 87 87 87 87 87 87 87 39 39 39 39 39 39 87 87 87 39 87 87 67 67 67 67 67 67 67 
67 67 67 67 67 67 67 87 39 39 39 87 87 87 87 39 39 39 39 39 39 39 39 39 39 39 39 39 39 39 39 39 39 39 39 39 39 87 87 87 39 87 87 67 67 67 67 67 67 67 
67 67 67 67 67 67 67 87 39 88 39 87 87 87 87 87 87 87 87 87 87 87 87 87 87 87 87 87 87 87 87 87 39 39 39 39 39 87 87 87 39 87 87 67 67 67 67 67 67 67 
67 67 67 67 67 67 67 87 39 39 39 87 87 87 87 87 87 87 87 87 87 87 87 87 87 87 87 87 87 87 87 87 87 87 87 87 87 87 87 87 87 87 87 67 67 67 67 67 67 67 
67 67 67 67 67 67 67 87 87 87 87 87 87 87 87 87 87 87 87 87 87 87 87 87 87 87 87 87 87 87 87 87 87 87 87 87 87 87 87 87 87 87 87 67 67 67 67 67 67 67 
67 67 67 67 67 67 67 67 67 67 67 67 67 67 67 67 67 67 67 67 67 67 67 67 67 67 67 67 67 67 67 67 67 67 67 67 67 67 67 67 67 67 67 67 67 67 67 67 67 67 
67 67 67 67 67 67 67 67 67 67 67 67 67 67 67 67 67 67 67 67 67 67 67 67 67 67 67 67 67 67 67 67 67 67 67 67 67 67 67 67 67 67 67 67 67 67 67 67 67 67 
67 67 67 67 67 67 67 67 67 67 67 67 67 67 67 67 67 67 67 67 67 67 67 67 67 67 67 67 67 67 67 67 67 67 67 67 67 67 67 67 67 67 67 67 67 67 67 67 67 67 
67 67 67 67 67 67 67 67 67 67 67 67 67 67 67 67 67 67 67 67 67 67 67 67 67 67 67 67 67 67 67 67 67 67 67 67 67 67 67 67 67 67 67 67 67 67 67 67 67 67 
67 67 67 67 67 67 67 67 67 67 67 67 67 67 67 67 67 67 67 67 67 67 67 67 67 67 67 67 67 67 67 67 67 67 67 67 67 67 67 67 67 67 67 67 67 67 67 67 67 67 
67 67 67 67 67 67 67 67 67 67 67 67 67 67 67 67 67 67 67 67 67 67 67 67 67 67 67 67 67 67 67 67 67 67 67 67 67 67 67 67 67 67 67 67 67 67 67 67 67 67 
